NO ./path_to_the_north_texture
SO ./path_to_the_south_texture
WE ./path_to_the_west_texture
EA ./path_to_the_east_texture

C 123,456,789
F 241,194,50

1111111111
1000000001
1000000001
1000000001
1000001111
1000001
1000001111
1000000001
1000000001
1111111111
