NO         ./textures/backroom_v1.png
SO    ./textures/backroom_h1.png
WE              ./textures/backroom_v2.png
EA         ./textures/backroom_h2.png

C               135,                206,                 250
F                105, 105,            105

1111111111
10000000011111
10000000010001
1000000E000001
10000011010001
10000010011111
1000001111
1000000001
1000000001
1111111111
