C 0,0,0
F 0,0,51

NO textures/SUPPORT_4A.PNG
SO textures/SUPPORT_4A.PNG
WE textures/SUPPORT_4A.PNG
EA textures/SUPPORT_4A.PNG

1111111111111111111111111
1000000000000000000000001
1000100000000000000100001
1000000000100010000000001
100010000000N000000100001
1000000000100010000000001
1000100000000000000100001
1000000000001000000000001
1000000000000000000000001
1111111111111111111111111

