NO ./textures/backroom_v1.png
SO ./textures/backroom_h1.png
WE ./textures/backroom_v2.png
EA ./textures/backroom_h2.png

C 158, 158, 98
F 130, 130, 130

1111111111
1001000M011111
1M010000010001
10M000000D00W1
10000011110001
10M0000M011111
1000000001
10000000M1
100M000001
1111111111
