F 0, 51 , 0
C 0, 0, 0

NO textures/HEDGE_1A.PNG
SO textures/HEDGE_1A.PNG
WE textures/HEDGE_1A.PNG
EA textures/HEDGE_1A.PNG

1111111111111111111
10W1001001001000001
1011000001000001001
1001001001111101111
1001111000001001001
1000000000000001001
1001111111111001001
1111000000000001011
100000000000000001
1111111111111111111

