F 0, 51 , 0
C 0, 0, 0

NO textures/HEDGE_1A.PNG
SO textures/HEDGE_1A.PNG
WE textures/HEDGE_1A.PNG
EA textures/HEDGE_1A.PNG


     111
     101
11111101111111111111
10W10010010010000001
10110000010000010001
100D0010011111011111
1001111000001001001
1000000000000001001
1001111111111001001
1111000000000001011
1000000000111000001
11111111111 1111111

