F 0, 51 , 0
C 0, 0, 0

NO textures/HEDGE_1A.PNG
SO textures/HEDGE_1A.PNG
WE textures/HEDGE_1A.PNG
EA textures/HEDGE_1A.PNG

111111111111111111111
10100000F000000000001
101010101011111110001
100010100010000010001
11111D101111101011101
100000101000101000001
101111101011101D11111
101000001010100000101
1010111110101D1110101
101010001010100010101
101110101010101010101
100000101010001010001
111011101011111011101
100000101000100010001
101010101110101110111
101E00100000100010101
101111111111111010101
10001000M000000010001
101010111011111111101
10D000001000000000001
111111111111111111111
