NO ./textures/backroom_v1.png
SO ./textures/backroom_h1.png
WE ./textures/backroom_v2.png
EA ./textures/backroom_h2.png

C 137, 207, 240
F 137, 207, 240

1111111111
10010000011111
10010000010001
10M0000E000001
10000011D100F1
10000010011111
10000011D1
10000000M1
100M000001
1111111111
