C 174, 214, 241
F 250, 215, 160

NO textures/SAND_1A.PNG
SO textures/PAPER_1B.PNG
WE textures/SAND_1A.PNG
EA textures/PAPER_1B.PNG

1111111111111111111
1001001001001001001
1001001001001001001
1001001001001001001
1001001000001001001
100000000S000000001
1000011111111000001
1111000000000001111       1111111111111111111
1000000101010000001       10010010010010011F1
1111111111M11111111       1001001001001001001
         101111111111111111001001001001001001
         10M000000000000000000001000001001001
         101111111111111111001001M01001000001
1111111111011111111       1001001001001001001
10010010010M1001001       1001000001000M01001
1001001001001001001       1111111111111111111
1001001001001001001
1001001000001001001
1000000000000000001
1000011111111000001
111100000000M001111
1000000101F10000001
1111111111111111111
