C 0,0,0
F 0,0,51

NO textures/SUPPORT_4A.PNG
SO textures/SUPPORT_4A.PNG
WE textures/SUPPORT_4A.PNG
EA textures/SUPPORT_4A.PNG

1111111111111111111111111
100M00000001F1000000M0001
1000100000000000000100001
1000000000100010000000001
100M10000000N0000001M0001
1000000000100010000000001
1000100000000000000100001
100M0000000010000000M0001
100000000000M000000000001
1111111111111111111111111

