C 33, 33, 33
F 66, 73, 73

NO textures/TECH_3B.PNG
SO textures/TECH_2F.PNG
WE textures/TECH_1E.PNG
EA textures/TECH_4F.PNG

1111111111111111111
1001001001001001001
1001001001001001001
1001001001001001001
1001001000001001001
100000000S000000001
1000011111111000001
1111000000000001111       1111111111111111111
1000000101010000001       10010010010010011F1
1111111111D11111111       1001001001001001001
         101111111111111111001001001001001001
         10DM0000000000000000D00100D001001001
         101111111111111111001M0100100100D001
1111111111D11111111       1001001M01001001001
1001001001M01001001       100100D00100D001001
1001001001001001001       1111111111111111111
1001001001001001001
1001001000001001001
1000000000000000001
1000011111111000001
11110M0000000M01111
100000011F110000001
1111111111111111111
