NO ./textures/backroom_v1.png
SO ./textures/backroom_h1.png
WE ./textures/backroom_v2.png
EA ./textures/backroom_h2.png

C 158, 158, 98
F 130, 130, 130

1111111111111111111
1E00D00000DM00000F1
101D101110101111101
1010100010100010001
1010111011111010101
1010001000001010101
1D11101110111M1M101
100M100010D00000101
1110111010101111101
10000010D0100000001
1011111010111011111
1010M00010001000001
1F10111111101110101
10101000001000D0101
1D10D01110101M10101
10D0100010001010001
1D11101011111011101
1M00001000000000001
1111111111111111111


